11111111111111111111111
1000C00000C0000001N0001
100001010010CCC00010101
11010N010010010N0010101
1C000000000000000000C11
1000C00000C0000001N0001
100001010010CCC00010101
11010N010010010N0010101
1C000000000000000000C11
1E00C00000C0000001N0001
100001010010CCC00010101
11010N010010010N0010101
1C00P000000000000000C11
11111111111111111111111