1111111111111111111111111
100100E0000C00N000C0N0001
1010011111001111101011111
100N00001010000000C000101
1P0001000000001N10001N001
1111111111111111111111111