1111111111111111111111111
10010000000C000000C000001
1010011111001111100001111
1P0001001E10000000C0CC101
1000010000000000000111001
1111111111111111111111111