1111111111111111111111111
10010000000C000000C000001
1010011111001111100000111
1P0001000E00000000C00C001
100001000C000000000111001
1111111111111111111111111