1111111111111111111111111111111111111111111111111111
100000C00000000000000000000000000CCCCCCC000000000001
1000011111111001111111110001111111110001111111111001
1000010000000001000000001001000000001001000000000001
1000011111111001000000001001000000001001000000000001
1000010000000001111111110001000000001001111111111001
100001000C0000010000100C0001000000001000000000001001
1000010000000001000001000001111111110001111111111001
10000P0C0000C00000000C000000C000000C0000E00000000001
1111111111111111111111111111111111111111111111111111