1111111111111111111111111
100100E0000C000000C000001
1010011111001111100011111
100000001010000000C000101
10P0010000000000000001001
1111111111111111111111111